00000000000000000
00011111111111110
0001C110000000C10
00010000111110110
0001P001100000010
00011111000111110
0001C110000000C10
00010000111110110
000100011E0000001
00011111111111110
00000000000000000