1111111111111
1P000000111E1
1101C1C000001
1111111111111