11111111111111111111
10010000000010C10001
100001111100000000C1
1P0011E0000C10110001
1100001011100000C001
11111111111111111111