0000000000110000111111001111111110
000111111100111100001C11C000000C10
0001000010000000000000110010000100
0001C1100000C00000000000F00001E110
00010110000000C0000010000000000110
0001P00010F01110000000010000001110
1111111111110001111111101111111000