00000000001100000
00011111110011110
0001C110000000C10
00010000111110110
0001P00110F000010
00001111110001100
0001C1100000C0010
00010000111110110
001100011E0000010
01000111110001100
00110110000000010
0001C00011111C110
00001111111111110
00000000000000000