0000000000110000111111001111111110
00011111110C111100001C11C000000C10
0001F0001000000000C00011001F000100
0001C1100000C000001000F00000011110
0001011C000000C0000110011100000110
0001P00010F0111000000001E000001110
1111111111110001111111101111111000