01100000001100001110101101111
01C11111110011110001C10010C10
1P00C110000000C00000000000001
1001000011111000000001E000001
10010001100000010000000000001
10000111110FC1100111100000010
011101C0000110011000011111110
00001111111001100111100000001