0000000000110000111111001111111110
00011111110C111100001C11C000000010
0001F00C100001E100C000110010000100
000101000010C10100100000F00001C110
0001001C000000C0000110011100000110
0001P00010001110000000000000001110
1111111111110001111111111111111000