1111111011
10010001E1
1P0001C001
0111101110