1110111111111111000
1001000000000000111
10000111110000C0001
1P0011C0000C1000001
11000C1011100000E01
1011110100011111111