00000000001100000
00011111110011110
0001C110000000C10
00010000111110110
0001P001100000010
00001111110001100
0001C1100000C0010
00010000111110110
000100011E0000010
00001111110001100
00011110000000010
0001C00011111C110
00011111111111110
00000000000000000